43 17
WWWWWWWWWWWWWWWWWWWWWWWWWWWWWWWWWWWWWWWWWWW
WSW000000000000000W000W000000000W000W00000W
W0W0WWWWWWWWWWWWW0W0WWW0WWW0WWW0W0W0W0WWW0W
W0WAW0000000WcW000W00000W0W0Wd00W0W000W0W0W
W0W0W0WWWWW0W0W0WWW0WWWWW0W0WWW0W0WWWWW0W0W
W0W0000aW000W0W000W0000000W000W0W000W00000W
W0WWWWWWW0WWW0WWW0WWW0WWWWWWW0W0WWW0WWW0WWW
W000000000W000W000W000WB000000W000W000W0W0W
WWWWWWWWWWW0W0W0WWWWWWW0WWWWWWWWW0WWW0W0W0W
WD000eW0000CW0W000W000W0W000W000W00000W0W0W
W0WWWWW0WWWWW0WWW0W0W0W0W0W0W0W0WWWWWWW0W0W
W00000W0W000000bW0W0W000W0W0W0W000W000W000W
W0WWW0W0W0WWWWWWW0W0WWWWW0W0W0W0WWW0W0WWW0W
W0W0W000W0W000W000W0W0W000W000W00000W0W000W
W0W0WWWWW0W0W0W0WWW0W0W0WWWWWWWWWWWWW0W0WWW
W00E0000W000W0000000W000000000000000W0000GW
WWWWWWWWWWWWWWWWWWWWWWWWWWWWWWWWWWWWWWWWWWW
