5 5
WWWWW
W000W
W0W0W
WS00W
WWWWW